11111111111
10000000E01
11111011001
10C0000C0P1
11111111111